8   8
########
#     ##
# # #  #
# # ## #
# # ##  
# # ####
#   ####
## #####